wwwwwwwwwwwwwwwwwwwwwwwwwwwwwwwwwwwwwwwwwwwwwwwwwwwwwwwwwwwwwwwwwwwwwww
w                    wwwwwwwwwwwwwwwwwwwwwww                        www
w                       wwwwwwwwwwwwww                A             www
w                       wwwwwwww                A                   www
w                       wwww                                        www
w                                                                   www
w                                                                   www
w                                                                   www
w                                                                   www
w                                                                   www
w                                                                   www
w                                                                   www
w                          k                                        d1w
w                                                                   d1w
w                                                                   d1w
w                                                                   www
w                                                                   www
w   s                                                               www
w                                                                   www
w                                                                   www
w                                                                   www
w                                       B                           www
w                                                                   www
w                                         B                         www
w                                   B                               www
w                                        B                          www
w                                                                   www
w                                                                   www
w                                                                   www
wwwwwwwwwwwwwwwwwwwwwwwwwwwwwwwwwwwwwwwwwwwwwwwwwwwwwwwwwwwwwwwwwwwwwww
