wwwwwwwwwwwwwwwwwwwwwwwwwwwwwwwwwwwwwwwwwwwwwwwwwwwwwwwwwwwwwwwwwwwww
w                    wwwwwwwwwwwwwwwwwwwwwww                        w
w                       wwwwwwwwwwwwww                              w
w                       wwwwwwww                                    w
w                       wwww                                        w
w                                                                   w
w                                                                   w
w                               A                                   w
w                         A                                         w
w                                                                   w
w                                 A                                 w
w                                                                   w
w                                                                   w
w                                                                   w
w                                                                   w
w                                                                   w
w                                                                   w
w   s                                                               w
w                                                                   w
w                                                                   w
w                                                                   w
w                                       B                           w
w                                                                   w
w                   e                     B                         w
w                   www             B                               w
w                        w               B                          w
w                       ww                                          w
w         e     w     wwww                                          w
w  w      n    www                                                  w
wwwwwwwwwwwwwwwwwwwwwwwwwwwwwwwwwwwwwwwwwwwwwwwwwwwwwwwwwwwwwwwwwwwww
