wwwwwwwwwwwwwwwwwwwwwwwwwwwwwwwwwwwwwwwwwwwwwwwwwwwwwwwwwwwwwwwwwwwwwww
w                    wwwwwwwwwwwwwwwwwwwwwww                        www
w                       wwwwwwwwwwwwww                              www
w                       wwwwwwww                                    www
w                       wwww                                        www
w                                                                   www
w                                                                   www
w                               A                                   www
w                         A                                         www
w                                                                   www
w                                 A                                 www
w                                                                   www
w                                                                    1w
w                                                                    1w
w                                                                    1w
w                                                                   www
w                                                                   www
w   s                                                               www
w                                                                   www
w                                                                   www
w                                                                   www
w                                       B                           www
w                                                                   www
w                                         B                         www
w                                   B                               www
w                                        B                          www
w                                                                   www
w                                                                   www
w                                                                   www
wwwwwwwwwwwwwwwwwwwwwwwwwwwwwwwwwwwwwwwwwwwwwwwwwwwwwwwwwwwwwwwwwwwwwww
